111111111
111110011
100000011
100212011
110111011
110212001
110000001
110011111
111111111
4,6
2,2;2,6;6,2;6,6
BEST_SCORE: