1111111
1112111
1110111
1200021
1110111
1112111
1111111
3,3
2,3;3,2;3,4;4,3