1111111111
1111111111
1111111111
1110000111
1110000001
1110200000
1000001020
1000201100
1000000011
1100000011
1111111111
1111111111
7,3
5,4;8,4;4,6
BEST_SCORE:

