111111111
100111001
100020001
100020001
111020111
111020111
111111111
3,4
2,2;2,4;2,6;4,5
BEST_SCORE:19
