1111111111
1111001111
1111000011
1112000011
1112200011
1110111111
1000010011
1000000011
1111110011
1111111111
7,5
2,4;3,6;5,3;7,2
BEST_SCORE: