1111111111
1111111111
1100200111
1100000111
1111100111
1120000011
1110012111
1100011111
1110011111
1111111111
5,6
3,3;3,5;7,4
BEST_SCORE: