111111111
110011111
112011111
102011111
100000001
102200001
111100111
111111111
2,3
3,3;4,2;4,3;4,5
BEST_SCORE: