[LEVEL]
11111111
11001001
11001001
11002221
10001001
10001001
11001111
11001111
11111111
3,6
2,5;3,5;4,5

[LEVEL]
111111
121001
120001
100001
100001
111111
3,2
2,2;2,3

[LEVEL]
1111111
1000001
1012101
1000001
1102201
1101201
1100001
1111021
1111111
5,2
3,2;3,4;4,3;4,4;6,3
