1111111111
1110011111
1100011111
1100211111
1111021111
1111001011
1111100011
1120001111
1111111111
5,7
2,3;5,5;7,4
BEST_SCORE: