1111111111
1000002211
1020000001
1000000001
1001120011
1001111011
1001111011
1001111111
1111111111
6,7
3,2;3,5;5,7;6,2
BEST_SCORE: