111111111
111100111
110000111
112000001
112000001
112020011
111000111
111111111
3,3
2,5;3,4;3,5;4,5
BEST_SCORE: