1111111
1000001
1012101
1000001
1102201
1101201
1100001
1111021
1111111
5,2
3,2;3,4;4,3;4,4;6,3
BEST_SCORE: